111111111111111111111
100010000000000011001
100010000000000011001
100011100000000000001
100000000000111000011
100010000000111000011
100010000000000000001
111111111111111111111
