NO textures/csgo.xpm
SO textures/stone.xpm
WE textures/test.xpm
EA textures/wolf.xpm

F 0,0,0
C 225,30,1

 111111111111
10000N00000001
 111111111111


