11111111111111111111111111
10000000000000000000000001
10000100000000000000000001
10010000000000000000000001
11111111111111111111111111
